11111111111111111111111111111111111111111111111111
110010000000001011010001110011001010100000010000E1
11000000001100000000100011000000001000000000000101
10000101000100000000000001010111000100110101010001
10000000010010000100000000010010000100000000000101
10000100C10000000010001100001000010001001010000001
10010000010000001010010000000001001010000101100111
10000000000001000000001000001101000000010101100001
11000000000010000111001100100000010000000010101001
10000001100000C00000000100000010001000010101000001
1100000C110100000010100000001110101010010111100001
10001000011011100100010110011000010010000010011001
100001100000100001000010011111100000001100C0000001
10001000000000010100000000000001100100010000010011
10000010100010001000000010000000010101100000110101
10110000111000C00000001000100000100001101000001001
10000011010100011000000010100101000000000000000001
10001011010010011100000010001010101100110C00000001
11000000001000001000000100010100000010100000000011
11101010001100010000001010000011010000010010100001
10000000101000000011001101000010000100000000100011
11000000000100000C00000111000000000001000100010011
110001001000C0100000000001101011001100010000000001
10110000000000100C00010001000000010000101000000001
10000000000000110000010001000010000000000000100011
100000000000000010C0101010011010001100001000101011
11010000100010000000001000000010000001C00000000101
1100101000000010000000010101000001001000C100001011
1P00100000011000010001001101000000100001C011000001
11111111111111111111111111111111111111111111111111
