11111111111111111111111111111111111111111111111111
100001010000001000111000000100000011111000000000E1
10000000000001001101100000000001010000111000000001
10000010000000000000000011100100000000010101000001
11C00010001000000100100000001110111000000100000001
100011100000000000C0010011100010000000000111000011
10110000C00010001000010000010000100100000010101101
100000101000000001000001100110C1000000001110000001
10000000100110100010001000011100010100000000100001
10000010100C0000010001100000C100000111010011000001
11001000000000011011000110100001010000000100000001
1100010000101000000C000001000001010000000000000011
10100000010001001000001010101001000111001110101101
10000010001000000000000000100000000100011001000011
10100001000000000000000001000010010100C01000111001
10101000000001101001100110010001101000000001000001
1000110100C01001000101010011000010000000101C001001
10000C01001010010001001001000000111010000000100101
10100110000010010000010000100001000100010010000001
10110000001100100000000100000010000000100100001101
10000001C00000001110010010000000011000000101000001
10000101000100100111000101100000010010000110011111
11000100100101010100000110000000011010010010000001
11000000010100000000010100010110100000000000001001
10100000000000001000010000100101000000001010100001
11101010001100001101000110010001000010100101000001
110000000010000100000000000000000010C0001010000001
1000000000011000000001100100001000100000100000C001
1P001000101000001000110000001000100101010000010101
11111111111111111111111111111111111111111111111111
