11111111111111111111111111111111111111111111111111111111111111
100101000010000C00000C00000000010001000000C00000C00000100000E1
10100101001000001000010000001001010100000000101001000000000101
10100100100010100010010000101001010010101010001001000100010101
10000000C00C0000000001000000C00000000C10C0000010000100000000C1
100101000010000C00000C00000000010001000000C00000C0000010000001
10100101001000001000010000001001010100000000101001000000000101
10100100100010100010010000101001010010101010001001000100010101
10000000C00C0000000001000000C00000000C10C0000010000100000000C1
100101000010000C00000C00000000010001000000C00000C0000010000001
10100101001000001000010000001001010100000000101001000000000101
10100100100010101010010000101001010010101010001001000100010101
10000000C00C0000100001000000C00000000C10C0000010000100000000C1
100101000010000C10000C00000000010001000000C00000C0000010000001
10100101001000001000010000001001010100000000101001000000000101
10100100100010101010010000101001010010101010001001000100010101
1P000000C00C0000100001000000C00000000C10C0000010000100000000C1
11111111111111111111111111111111111111111111111111111111111111
